"2020Q3";"Total";"Copenhagen";633035;312306;320729
"2020Q3";"Total";"Frederiksberg";104118;49446;54672
"2020Q3";"Total";"Dragør";14515;7117;7398
"2020Q3";"Total";"Tårnby";42785;21201;21584
"2020Q3";"Total";"Albertslund";27543;13693;13850
"2020Q3";"Total";"Ballerup";48916;23965;24951
"2020Q3";"Total";"Brøndby";35112;17241;17871
"2020Q3";"Total";"Gentofte";74773;35684;39089
"2020Q3";"Total";"Gladsaxe";69109;34318;34791
"2020Q3";"Total";"Glostrup";23322;11575;11747
"2020Q3";"Total";"Herlev";28933;14100;14833
"2020Q3";"Total";"Hvidovre";53422;26322;27100
"2020Q3";"Total";"Høje-Taastrup";50923;25518;25405
"2020Q3";"Total";"Ishøj";23018;11436;11582
"2020Q3";"Total";"Lyngby-Taarbæk";56046;27446;28600
"2020Q3";"Total";"Rødovre";40848;19968;20880
"2020Q3";"Total";"Vallensbæk";16510;8273;8237
"2020Q3";"Total";"Allerød";25637;12528;13109
"2020Q3";"Total";"Egedal";43424;21588;21836
"2020Q3";"Total";"Fredensborg";40971;19855;21116
"2020Q3";"Total";"Frederikssund";45425;22479;22946
"2020Q3";"Total";"Furesø";41011;20002;21009
"2020Q3";"Total";"Gribskov";41135;20528;20607
"2020Q3";"Total";"Halsnæs";31537;15684;15853
"2020Q3";"Total";"Helsingør";62966;30516;32450
"2020Q3";"Total";"Hillerød";51234;25198;26036
"2020Q3";"Total";"Hørsholm";24814;11709;13105
"2020Q3";"Total";"Rudersdal";56623;27596;29027
"2020Q3";"Total";"Bornholm";39497;19542;19955
"2020Q3";"Total";"Christiansø";87;48;39
"2020Q3";"Total";"Greve";50520;24939;25581
"2020Q3";"Total";"Køge";61184;30414;30770
"2020Q3";"Total";"Lejre";28107;13966;14141
"2020Q3";"Total";"Roskilde";88456;43429;45027
"2020Q3";"Total";"Solrød";23347;11515;11832
"2020Q3";"Total";"Faxe";36647;18612;18035
"2020Q3";"Total";"Guldborgsund";60433;30156;30277
"2020Q3";"Total";"Holbæk";71685;35691;35994
"2020Q3";"Total";"Kalundborg";48374;24244;24130
"2020Q3";"Total";"Lolland";40816;20642;20174
"2020Q3";"Total";"Næstved";83165;41275;41890
"2020Q3";"Total";"Odsherred";32955;16522;16433
"2020Q3";"Total";"Ringsted";34852;17520;17332
"2020Q3";"Total";"Slagelse";79155;39351;39804
"2020Q3";"Total";"Sorø";29872;15005;14867
"2020Q3";"Total";"Stevns";22840;11543;11297
"2020Q3";"Total";"Vordingborg";45426;22551;22875
"2020Q3";"Total";"Assens";40903;20524;20379
"2020Q3";"Total";"Faaborg-Midtfyn";51571;25844;25727
"2020Q3";"Total";"Kerteminde";23824;11744;12080
"2020Q3";"Total";"Langeland";12395;6263;6132
"2020Q3";"Total";"Middelfart";38998;19515;19483
"2020Q3";"Total";"Nordfyns";29631;14955;14676
"2020Q3";"Total";"Nyborg";31933;15754;16179
"2020Q3";"Total";"Odense";204718;101254;103464
"2020Q3";"Total";"Svendborg";58261;28933;29328
"2020Q3";"Total";"Ærø";5987;3002;2985
"2020Q3";"Total";"Billund";26560;13380;13180
"2020Q3";"Total";"Esbjerg";115650;57980;57670
"2020Q3";"Total";"Fanø";3486;1682;1804
"2020Q3";"Total";"Fredericia";51386;25829;25557
"2020Q3";"Total";"Haderslev";55518;27828;27690
"2020Q3";"Total";"Kolding";92995;46473;46522
"2020Q3";"Total";"Sønderborg";74083;36991;37092
"2020Q3";"Total";"Tønder";37174;18723;18451
"2020Q3";"Total";"Varde";49886;25293;24593
"2020Q3";"Total";"Vejen";42805;21821;20984
"2020Q3";"Total";"Vejle";116468;58298;58170
"2020Q3";"Total";"Aabenraa";58735;29335;29400
"2020Q3";"Total";"Favrskov";48393;24395;23998
"2020Q3";"Total";"Hedensted";46731;23850;22881
"2020Q3";"Total";"Horsens";91469;46060;45409
"2020Q3";"Total";"Norddjurs";36994;18926;18068
"2020Q3";"Total";"Odder";22888;11262;11626
"2020Q3";"Total";"Randers";98122;49063;49059
"2020Q3";"Total";"Samsø";3651;1814;1837
"2020Q3";"Total";"Silkeborg";94648;47095;47553
"2020Q3";"Total";"Skanderborg";63070;31429;31641
"2020Q3";"Total";"Syddjurs";43107;21647;21460
"2020Q3";"Total";"Aarhus";349433;171806;177627
"2020Q3";"Total";"Herning";89411;45169;44242
"2020Q3";"Total";"Holstebro";58685;29335;29350
"2020Q3";"Total";"Ikast-Brande";41395;21153;20242
"2020Q3";"Total";"Lemvig";19662;10039;9623
"2020Q3";"Total";"Ringkøbing-Skjern";56366;28647;27719
"2020Q3";"Total";"Skive";45728;23262;22466
"2020Q3";"Total";"Struer";20951;10568;10383
"2020Q3";"Total";"Viborg";96706;48657;48049
"2020Q3";"Total";"Brønderslev";36295;18407;17888
"2020Q3";"Total";"Frederikshavn";59353;29944;29409
"2020Q3";"Total";"Hjørring";64450;32310;32140
"2020Q3";"Total";"Jammerbugt";38357;19388;18969
"2020Q3";"Total";"Læsø";1776;880;896
"2020Q3";"Total";"Mariagerfjord";41687;21233;20454
"2020Q3";"Total";"Morsø";20214;10238;9976
"2020Q3";"Total";"Rebild";30359;15439;14920
"2020Q3";"Total";"Thisted";43383;21918;21465
"2020Q3";"Total";"Vesthimmerlands";36647;18611;18036
"2020Q3";"Total";"Aalborg";217316;109433;107883
"2020Q3";"Never married";"Copenhagen";414218;210516;203702
"2020Q3";"Never married";"Frederiksberg";60802;30321;30481
"2020Q3";"Never married";"Dragør";5866;3089;2777
"2020Q3";"Never married";"Tårnby";19945;10666;9279
"2020Q3";"Never married";"Albertslund";13726;7347;6379
"2020Q3";"Never married";"Ballerup";22667;12071;10596
"2020Q3";"Never married";"Brøndby";16299;8624;7675
"2020Q3";"Never married";"Gentofte";35169;17841;17328
"2020Q3";"Never married";"Gladsaxe";34752;18639;16113
"2020Q3";"Never married";"Glostrup";11386;6136;5250
"2020Q3";"Never married";"Herlev";13810;7296;6514
"2020Q3";"Never married";"Hvidovre";26581;13999;12582
"2020Q3";"Never married";"Høje-Taastrup";23728;12751;10977
"2020Q3";"Never married";"Ishøj";10873;5788;5085
"2020Q3";"Never married";"Lyngby-Taarbæk";27764;14811;12953
"2020Q3";"Never married";"Rødovre";20198;10689;9509
"2020Q3";"Never married";"Vallensbæk";7318;3944;3374
"2020Q3";"Never married";"Allerød";10605;5499;5106
"2020Q3";"Never married";"Egedal";18396;9746;8650
"2020Q3";"Never married";"Fredensborg";17247;8972;8275
"2020Q3";"Never married";"Frederikssund";18645;10087;8558
"2020Q3";"Never married";"Furesø";17505;9253;8252
"2020Q3";"Never married";"Gribskov";16036;8737;7299
"2020Q3";"Never married";"Halsnæs";12777;6949;5828
"2020Q3";"Never married";"Helsingør";27327;14352;12975
"2020Q3";"Never married";"Hillerød";23416;12391;11025
"2020Q3";"Never married";"Hørsholm";9648;4986;4662
"2020Q3";"Never married";"Rudersdal";24684;13068;11616
"2020Q3";"Never married";"Bornholm";16066;8755;7311
"2020Q3";"Never married";"Christiansø";33;22;11
"2020Q3";"Never married";"Greve";21065;11234;9831
"2020Q3";"Never married";"Køge";27447;14789;12658
"2020Q3";"Never married";"Lejre";11637;6132;5505
"2020Q3";"Never married";"Roskilde";41580;21927;19653
"2020Q3";"Never married";"Solrød";10065;5301;4764
"2020Q3";"Never married";"Faxe";15681;8705;6976
"2020Q3";"Never married";"Guldborgsund";25813;14148;11665
"2020Q3";"Never married";"Holbæk";32366;17464;14902
"2020Q3";"Never married";"Kalundborg";21195;11583;9612
"2020Q3";"Never married";"Lolland";17056;9572;7484
"2020Q3";"Never married";"Næstved";38262;20568;17694
"2020Q3";"Never married";"Odsherred";13051;7253;5798
"2020Q3";"Never married";"Ringsted";16089;8704;7385
"2020Q3";"Never married";"Slagelse";37477;20168;17309
"2020Q3";"Never married";"Sorø";13306;7262;6044
"2020Q3";"Never married";"Stevns";9138;5000;4138
"2020Q3";"Never married";"Vordingborg";19118;10350;8768
"2020Q3";"Never married";"Assens";17664;9622;8042
"2020Q3";"Never married";"Faaborg-Midtfyn";22137;12039;10098
"2020Q3";"Never married";"Kerteminde";9831;5252;4579
"2020Q3";"Never married";"Langeland";4544;2601;1943
"2020Q3";"Never married";"Middelfart";16596;8980;7616
"2020Q3";"Never married";"Nordfyns";12670;6936;5734
"2020Q3";"Never married";"Nyborg";13827;7360;6467
"2020Q3";"Never married";"Odense";112672;59180;53492
"2020Q3";"Never married";"Svendborg";26281;14220;12061
"2020Q3";"Never married";"Ærø";2203;1281;922
"2020Q3";"Never married";"Billund";11755;6453;5302
"2020Q3";"Never married";"Esbjerg";55330;29892;25438
"2020Q3";"Never married";"Fanø";1267;658;609
"2020Q3";"Never married";"Fredericia";23752;12947;10805
"2020Q3";"Never married";"Haderslev";24823;13494;11329
"2020Q3";"Never married";"Kolding";44969;24020;20949
"2020Q3";"Never married";"Sønderborg";32180;17660;14520
"2020Q3";"Never married";"Tønder";15764;8752;7012
"2020Q3";"Never married";"Varde";21706;11992;9714
"2020Q3";"Never married";"Vejen";19353;10681;8672
"2020Q3";"Never married";"Vejle";55161;29501;25660
"2020Q3";"Never married";"Aabenraa";25364;13701;11663
"2020Q3";"Never married";"Favrskov";21843;11815;10028
"2020Q3";"Never married";"Hedensted";20335;11272;9063
"2020Q3";"Never married";"Horsens";44741;24152;20589
"2020Q3";"Never married";"Norddjurs";16375;9255;7120
"2020Q3";"Never married";"Odder";9603;5092;4511
"2020Q3";"Never married";"Randers";47342;25432;21910
"2020Q3";"Never married";"Samsø";1291;733;558
"2020Q3";"Never married";"Silkeborg";44180;23455;20725
"2020Q3";"Never married";"Skanderborg";29040;15339;13701
"2020Q3";"Never married";"Syddjurs";18125;9787;8338
"2020Q3";"Never married";"Aarhus";208470;106923;101547
"2020Q3";"Never married";"Herning";42075;22850;19225
"2020Q3";"Never married";"Holstebro";27545;14742;12803
"2020Q3";"Never married";"Ikast-Brande";18658;10325;8333
"2020Q3";"Never married";"Lemvig";7932;4467;3465
"2020Q3";"Never married";"Ringkøbing-Skjern";24244;13518;10726
"2020Q3";"Never married";"Skive";20206;11314;8892
"2020Q3";"Never married";"Struer";8496;4721;3775
"2020Q3";"Never married";"Viborg";45423;24698;20725
"2020Q3";"Never married";"Brønderslev";16301;8996;7305
"2020Q3";"Never married";"Frederikshavn";24745;13797;10948
"2020Q3";"Never married";"Hjørring";28682;15681;13001
"2020Q3";"Never married";"Jammerbugt";16404;9048;7356
"2020Q3";"Never married";"Læsø";607;349;258
"2020Q3";"Never married";"Mariagerfjord";18150;10139;8011
"2020Q3";"Never married";"Morsø";8804;4913;3891
"2020Q3";"Never married";"Rebild";13751;7534;6217
"2020Q3";"Never married";"Thisted";18757;10333;8424
"2020Q3";"Never married";"Vesthimmerlands";16158;9008;7150
"2020Q3";"Never married";"Aalborg";118694;63804;54890
"2020Q3";"Married/separated";"Copenhagen";149291;75628;73663
"2020Q3";"Married/separated";"Frederiksberg";28951;14609;14342
"2020Q3";"Married/separated";"Dragør";6535;3277;3258
"2020Q3";"Married/separated";"Tårnby";16466;8235;8231
"2020Q3";"Married/separated";"Albertslund";9915;4963;4952
"2020Q3";"Married/separated";"Ballerup";18409;9176;9233
"2020Q3";"Married/separated";"Brøndby";13215;6628;6587
"2020Q3";"Married/separated";"Gentofte";28803;14420;14383
"2020Q3";"Married/separated";"Gladsaxe";24526;12263;12263
"2020Q3";"Married/separated";"Glostrup";8324;4182;4142
"2020Q3";"Married/separated";"Herlev";10498;5242;5256
"2020Q3";"Married/separated";"Hvidovre";19145;9590;9555
"2020Q3";"Married/separated";"Høje-Taastrup";20155;10159;9996
"2020Q3";"Married/separated";"Ishøj";8859;4438;4421
"2020Q3";"Married/separated";"Lyngby-Taarbæk";20232;10103;10129
"2020Q3";"Married/separated";"Rødovre";14299;7137;7162
"2020Q3";"Married/separated";"Vallensbæk";7194;3603;3591
"2020Q3";"Married/separated";"Allerød";11820;5902;5918
"2020Q3";"Married/separated";"Egedal";19668;9862;9806
"2020Q3";"Married/separated";"Fredensborg";17534;8765;8769
"2020Q3";"Married/separated";"Frederikssund";18964;9500;9464
"2020Q3";"Married/separated";"Furesø";17818;8890;8928
"2020Q3";"Married/separated";"Gribskov";17797;8946;8851
"2020Q3";"Married/separated";"Halsnæs";12999;6504;6495
"2020Q3";"Married/separated";"Helsingør";24424;12202;12222
"2020Q3";"Married/separated";"Hillerød";20533;10268;10265
"2020Q3";"Married/separated";"Hørsholm";10739;5358;5381
"2020Q3";"Married/separated";"Rudersdal";23570;11799;11771
"2020Q3";"Married/separated";"Bornholm";15878;7960;7918
"2020Q3";"Married/separated";"Christiansø";42;21;21
"2020Q3";"Married/separated";"Greve";22005;11029;10976
"2020Q3";"Married/separated";"Køge";24264;12153;12111
"2020Q3";"Married/separated";"Lejre";12527;6274;6253
"2020Q3";"Married/separated";"Roskilde";34214;17090;17124
"2020Q3";"Married/separated";"Solrød";10149;5077;5072
"2020Q3";"Married/separated";"Faxe";14847;7517;7330
"2020Q3";"Married/separated";"Guldborgsund";22836;11458;11378
"2020Q3";"Married/separated";"Holbæk";27753;13907;13846
"2020Q3";"Married/separated";"Kalundborg";18386;9206;9180
"2020Q3";"Married/separated";"Lolland";15314;7725;7589
"2020Q3";"Married/separated";"Næstved";30785;15441;15344
"2020Q3";"Married/separated";"Odsherred";13386;6715;6671
"2020Q3";"Married/separated";"Ringsted";13557;6891;6666
"2020Q3";"Married/separated";"Slagelse";28353;14201;14152
"2020Q3";"Married/separated";"Sorø";11632;5835;5797
"2020Q3";"Married/separated";"Stevns";9908;4978;4930
"2020Q3";"Married/separated";"Vordingborg";17498;8783;8715
"2020Q3";"Married/separated";"Assens";16764;8411;8353
"2020Q3";"Married/separated";"Faaborg-Midtfyn";21198;10633;10565
"2020Q3";"Married/separated";"Kerteminde";10046;5033;5013
"2020Q3";"Married/separated";"Langeland";5248;2666;2582
"2020Q3";"Married/separated";"Middelfart";16219;8128;8091
"2020Q3";"Married/separated";"Nordfyns";12473;6260;6213
"2020Q3";"Married/separated";"Nyborg";12757;6385;6372
"2020Q3";"Married/separated";"Odense";64848;32474;32374
"2020Q3";"Married/separated";"Svendborg";22289;11141;11148
"2020Q3";"Married/separated";"Ærø";2558;1295;1263
"2020Q3";"Married/separated";"Billund";11042;5547;5495
"2020Q3";"Married/separated";"Esbjerg";43404;21767;21637
"2020Q3";"Married/separated";"Fanø";1550;778;772
"2020Q3";"Married/separated";"Fredericia";19382;9712;9670
"2020Q3";"Married/separated";"Haderslev";21835;10962;10873
"2020Q3";"Married/separated";"Kolding";34954;17500;17454
"2020Q3";"Married/separated";"Sønderborg";30186;15117;15069
"2020Q3";"Married/separated";"Tønder";15446;7756;7690
"2020Q3";"Married/separated";"Varde";21243;10646;10597
"2020Q3";"Married/separated";"Vejen";17399;8821;8578
"2020Q3";"Married/separated";"Vejle";45210;22778;22432
"2020Q3";"Married/separated";"Aabenraa";23883;12003;11880
"2020Q3";"Married/separated";"Favrskov";20595;10322;10273
"2020Q3";"Married/separated";"Hedensted";19924;10020;9904
"2020Q3";"Married/separated";"Horsens";33973;17156;16817
"2020Q3";"Married/separated";"Norddjurs";14316;7214;7102
"2020Q3";"Married/separated";"Odder";9815;4900;4915
"2020Q3";"Married/separated";"Randers";35883;17990;17893
"2020Q3";"Married/separated";"Samsø";1561;785;776
"2020Q3";"Married/separated";"Silkeborg";37238;18645;18593
"2020Q3";"Married/separated";"Skanderborg";26615;13308;13307
"2020Q3";"Married/separated";"Syddjurs";18226;9146;9080
"2020Q3";"Married/separated";"Aarhus";102228;51148;51080
"2020Q3";"Married/separated";"Herning";35628;17918;17710
"2020Q3";"Married/separated";"Holstebro";23355;11706;11649
"2020Q3";"Married/separated";"Ikast-Brande";17034;8590;8444
"2020Q3";"Married/separated";"Lemvig";8751;4408;4343
"2020Q3";"Married/separated";"Ringkøbing-Skjern";24308;12202;12106
"2020Q3";"Married/separated";"Skive";18483;9262;9221
"2020Q3";"Married/separated";"Struer";9098;4567;4531
"2020Q3";"Married/separated";"Viborg";37743;18915;18828
"2020Q3";"Married/separated";"Brønderslev";14706;7371;7335
"2020Q3";"Married/separated";"Frederikshavn";24487;12350;12137
"2020Q3";"Married/separated";"Hjørring";25570;12809;12761
"2020Q3";"Married/separated";"Jammerbugt";16260;8151;8109
"2020Q3";"Married/separated";"Læsø";752;379;373
"2020Q3";"Married/separated";"Mariagerfjord";17082;8570;8512
"2020Q3";"Married/separated";"Morsø";8096;4065;4031
"2020Q3";"Married/separated";"Rebild";12704;6374;6330
"2020Q3";"Married/separated";"Thisted";18046;9106;8940
"2020Q3";"Married/separated";"Vesthimmerlands";14762;7428;7334
"2020Q3";"Married/separated";"Aalborg";70902;35487;35415
"2020Q3";"Widowed";"Copenhagen";14502;3141;11361
"2020Q3";"Widowed";"Frederiksberg";4204;861;3343
"2020Q3";"Widowed";"Dragør";878;228;650
"2020Q3";"Widowed";"Tårnby";2233;545;1688
"2020Q3";"Widowed";"Albertslund";1157;297;860
"2020Q3";"Widowed";"Ballerup";2754;656;2098
"2020Q3";"Widowed";"Brøndby";1907;465;1442
"2020Q3";"Widowed";"Gentofte";3404;685;2719
"2020Q3";"Widowed";"Gladsaxe";2984;642;2342
"2020Q3";"Widowed";"Glostrup";1186;245;941
"2020Q3";"Widowed";"Herlev";1565;367;1198
"2020Q3";"Widowed";"Hvidovre";2480;575;1905
"2020Q3";"Widowed";"Høje-Taastrup";2283;563;1720
"2020Q3";"Widowed";"Ishøj";970;234;736
"2020Q3";"Widowed";"Lyngby-Taarbæk";2731;579;2152
"2020Q3";"Widowed";"Rødovre";2054;445;1609
"2020Q3";"Widowed";"Vallensbæk";717;178;539
"2020Q3";"Widowed";"Allerød";1212;296;916
"2020Q3";"Widowed";"Egedal";1936;501;1435
"2020Q3";"Widowed";"Fredensborg";1969;439;1530
"2020Q3";"Widowed";"Frederikssund";2792;709;2083
"2020Q3";"Widowed";"Furesø";2150;489;1661
"2020Q3";"Widowed";"Gribskov";2525;690;1835
"2020Q3";"Widowed";"Halsnæs";1994;522;1472
"2020Q3";"Widowed";"Helsingør";3550;821;2729
"2020Q3";"Widowed";"Hillerød";2437;580;1857
"2020Q3";"Widowed";"Hørsholm";1673;332;1341
"2020Q3";"Widowed";"Rudersdal";3236;732;2504
"2020Q3";"Widowed";"Bornholm";2838;676;2162
"2020Q3";"Widowed";"Christiansø";6;2;4
"2020Q3";"Widowed";"Greve";2611;688;1923
"2020Q3";"Widowed";"Køge";3119;804;2315
"2020Q3";"Widowed";"Lejre";1438;390;1048
"2020Q3";"Widowed";"Roskilde";4221;1015;3206
"2020Q3";"Widowed";"Solrød";1047;271;776
"2020Q3";"Widowed";"Faxe";2082;554;1528
"2020Q3";"Widowed";"Guldborgsund";4337;1096;3241
"2020Q3";"Widowed";"Holbæk";3863;949;2914
"2020Q3";"Widowed";"Kalundborg";3071;791;2280
"2020Q3";"Widowed";"Lolland";3317;850;2467
"2020Q3";"Widowed";"Næstved";4652;1141;3511
"2020Q3";"Widowed";"Odsherred";2427;635;1792
"2020Q3";"Widowed";"Ringsted";1679;429;1250
"2020Q3";"Widowed";"Slagelse";4580;1105;3475
"2020Q3";"Widowed";"Sorø";1683;423;1260
"2020Q3";"Widowed";"Stevns";1420;398;1022
"2020Q3";"Widowed";"Vordingborg";3189;850;2339
"2020Q3";"Widowed";"Assens";2391;599;1792
"2020Q3";"Widowed";"Faaborg-Midtfyn";3194;833;2361
"2020Q3";"Widowed";"Kerteminde";1605;403;1202
"2020Q3";"Widowed";"Langeland";1084;273;811
"2020Q3";"Widowed";"Middelfart";2260;623;1637
"2020Q3";"Widowed";"Nordfyns";1759;451;1308
"2020Q3";"Widowed";"Nyborg";1989;503;1486
"2020Q3";"Widowed";"Odense";9067;2119;6948
"2020Q3";"Widowed";"Svendborg";3430;854;2576
"2020Q3";"Widowed";"Ærø";545;114;431
"2020Q3";"Widowed";"Billund";1535;383;1152
"2020Q3";"Widowed";"Esbjerg";5908;1445;4463
"2020Q3";"Widowed";"Fanø";263;72;191
"2020Q3";"Widowed";"Fredericia";2731;671;2060
"2020Q3";"Widowed";"Haderslev";3325;803;2522
"2020Q3";"Widowed";"Kolding";4377;1106;3271
"2020Q3";"Widowed";"Sønderborg";4628;1075;3553
"2020Q3";"Widowed";"Tønder";2377;558;1819
"2020Q3";"Widowed";"Varde";2884;714;2170
"2020Q3";"Widowed";"Vejen";2404;585;1819
"2020Q3";"Widowed";"Vejle";5436;1324;4112
"2020Q3";"Widowed";"Aabenraa";3517;869;2648
"2020Q3";"Widowed";"Favrskov";2226;546;1680
"2020Q3";"Widowed";"Hedensted";2482;638;1844
"2020Q3";"Widowed";"Horsens";4210;1040;3170
"2020Q3";"Widowed";"Norddjurs";2445;626;1819
"2020Q3";"Widowed";"Odder";1279;304;975
"2020Q3";"Widowed";"Randers";5237;1342;3895
"2020Q3";"Widowed";"Samsø";339;85;254
"2020Q3";"Widowed";"Silkeborg";4462;1132;3330
"2020Q3";"Widowed";"Skanderborg";2546;658;1888
"2020Q3";"Widowed";"Syddjurs";2474;661;1813
"2020Q3";"Widowed";"Aarhus";11744;2766;8978
"2020Q3";"Widowed";"Herning";4474;1131;3343
"2020Q3";"Widowed";"Holstebro";2995;755;2240
"2020Q3";"Widowed";"Ikast-Brande";2074;523;1551
"2020Q3";"Widowed";"Lemvig";1354;350;1004
"2020Q3";"Widowed";"Ringkøbing-Skjern";3323;792;2531
"2020Q3";"Widowed";"Skive";2819;730;2089
"2020Q3";"Widowed";"Struer";1366;354;1012
"2020Q3";"Widowed";"Viborg";4918;1213;3705
"2020Q3";"Widowed";"Brønderslev";2154;572;1582
"2020Q3";"Widowed";"Frederikshavn";4205;1077;3128
"2020Q3";"Widowed";"Hjørring";3932;976;2956
"2020Q3";"Widowed";"Jammerbugt";2399;646;1753
"2020Q3";"Widowed";"Læsø";199;53;146
"2020Q3";"Widowed";"Mariagerfjord";2504;646;1858
"2020Q3";"Widowed";"Morsø";1432;352;1080
"2020Q3";"Widowed";"Rebild";1519;372;1147
"2020Q3";"Widowed";"Thisted";2822;691;2131
"2020Q3";"Widowed";"Vesthimmerlands";2336;591;1745
"2020Q3";"Widowed";"Aalborg";9830;2518;7312
"2020Q3";"Divorced";"Copenhagen";55024;23021;32003
"2020Q3";"Divorced";"Frederiksberg";10161;3655;6506
"2020Q3";"Divorced";"Dragør";1236;523;713
"2020Q3";"Divorced";"Tårnby";4141;1755;2386
"2020Q3";"Divorced";"Albertslund";2745;1086;1659
"2020Q3";"Divorced";"Ballerup";5086;2062;3024
"2020Q3";"Divorced";"Brøndby";3691;1524;2167
"2020Q3";"Divorced";"Gentofte";7397;2738;4659
"2020Q3";"Divorced";"Gladsaxe";6847;2774;4073
"2020Q3";"Divorced";"Glostrup";2426;1012;1414
"2020Q3";"Divorced";"Herlev";3060;1195;1865
"2020Q3";"Divorced";"Hvidovre";5216;2158;3058
"2020Q3";"Divorced";"Høje-Taastrup";4757;2045;2712
"2020Q3";"Divorced";"Ishøj";2316;976;1340
"2020Q3";"Divorced";"Lyngby-Taarbæk";5319;1953;3366
"2020Q3";"Divorced";"Rødovre";4297;1697;2600
"2020Q3";"Divorced";"Vallensbæk";1281;548;733
"2020Q3";"Divorced";"Allerød";2000;831;1169
"2020Q3";"Divorced";"Egedal";3424;1479;1945
"2020Q3";"Divorced";"Fredensborg";4221;1679;2542
"2020Q3";"Divorced";"Frederikssund";5024;2183;2841
"2020Q3";"Divorced";"Furesø";3538;1370;2168
"2020Q3";"Divorced";"Gribskov";4777;2155;2622
"2020Q3";"Divorced";"Halsnæs";3767;1709;2058
"2020Q3";"Divorced";"Helsingør";7665;3141;4524
"2020Q3";"Divorced";"Hillerød";4848;1959;2889
"2020Q3";"Divorced";"Hørsholm";2754;1033;1721
"2020Q3";"Divorced";"Rudersdal";5133;1997;3136
"2020Q3";"Divorced";"Bornholm";4715;2151;2564
"2020Q3";"Divorced";"Christiansø";6;3;3
"2020Q3";"Divorced";"Greve";4839;1988;2851
"2020Q3";"Divorced";"Køge";6354;2668;3686
"2020Q3";"Divorced";"Lejre";2505;1170;1335
"2020Q3";"Divorced";"Roskilde";8441;3397;5044
"2020Q3";"Divorced";"Solrød";2086;866;1220
"2020Q3";"Divorced";"Faxe";4037;1836;2201
"2020Q3";"Divorced";"Guldborgsund";7447;3454;3993
"2020Q3";"Divorced";"Holbæk";7703;3371;4332
"2020Q3";"Divorced";"Kalundborg";5722;2664;3058
"2020Q3";"Divorced";"Lolland";5129;2495;2634
"2020Q3";"Divorced";"Næstved";9466;4125;5341
"2020Q3";"Divorced";"Odsherred";4091;1919;2172
"2020Q3";"Divorced";"Ringsted";3527;1496;2031
"2020Q3";"Divorced";"Slagelse";8745;3877;4868
"2020Q3";"Divorced";"Sorø";3251;1485;1766
"2020Q3";"Divorced";"Stevns";2374;1167;1207
"2020Q3";"Divorced";"Vordingborg";5621;2568;3053
"2020Q3";"Divorced";"Assens";4084;1892;2192
"2020Q3";"Divorced";"Faaborg-Midtfyn";5042;2339;2703
"2020Q3";"Divorced";"Kerteminde";2342;1056;1286
"2020Q3";"Divorced";"Langeland";1519;723;796
"2020Q3";"Divorced";"Middelfart";3923;1784;2139
"2020Q3";"Divorced";"Nordfyns";2729;1308;1421
"2020Q3";"Divorced";"Nyborg";3360;1506;1854
"2020Q3";"Divorced";"Odense";18131;7481;10650
"2020Q3";"Divorced";"Svendborg";6261;2718;3543
"2020Q3";"Divorced";"Ærø";681;312;369
"2020Q3";"Divorced";"Billund";2228;997;1231
"2020Q3";"Divorced";"Esbjerg";11008;4876;6132
"2020Q3";"Divorced";"Fanø";406;174;232
"2020Q3";"Divorced";"Fredericia";5521;2499;3022
"2020Q3";"Divorced";"Haderslev";5535;2569;2966
"2020Q3";"Divorced";"Kolding";8695;3847;4848
"2020Q3";"Divorced";"Sønderborg";7089;3139;3950
"2020Q3";"Divorced";"Tønder";3587;1657;1930
"2020Q3";"Divorced";"Varde";4053;1941;2112
"2020Q3";"Divorced";"Vejen";3649;1734;1915
"2020Q3";"Divorced";"Vejle";10661;4695;5966
"2020Q3";"Divorced";"Aabenraa";5971;2762;3209
"2020Q3";"Divorced";"Favrskov";3729;1712;2017
"2020Q3";"Divorced";"Hedensted";3990;1920;2070
"2020Q3";"Divorced";"Horsens";8545;3712;4833
"2020Q3";"Divorced";"Norddjurs";3858;1831;2027
"2020Q3";"Divorced";"Odder";2191;966;1225
"2020Q3";"Divorced";"Randers";9660;4299;5361
"2020Q3";"Divorced";"Samsø";460;211;249
"2020Q3";"Divorced";"Silkeborg";8768;3863;4905
"2020Q3";"Divorced";"Skanderborg";4869;2124;2745
"2020Q3";"Divorced";"Syddjurs";4282;2053;2229
"2020Q3";"Divorced";"Aarhus";26991;10969;16022
"2020Q3";"Divorced";"Herning";7234;3270;3964
"2020Q3";"Divorced";"Holstebro";4790;2132;2658
"2020Q3";"Divorced";"Ikast-Brande";3629;1715;1914
"2020Q3";"Divorced";"Lemvig";1625;814;811
"2020Q3";"Divorced";"Ringkøbing-Skjern";4491;2135;2356
"2020Q3";"Divorced";"Skive";4220;1956;2264
"2020Q3";"Divorced";"Struer";1991;926;1065
"2020Q3";"Divorced";"Viborg";8622;3831;4791
"2020Q3";"Divorced";"Brønderslev";3134;1468;1666
"2020Q3";"Divorced";"Frederikshavn";5916;2720;3196
"2020Q3";"Divorced";"Hjørring";6266;2844;3422
"2020Q3";"Divorced";"Jammerbugt";3294;1543;1751
"2020Q3";"Divorced";"Læsø";218;99;119
"2020Q3";"Divorced";"Mariagerfjord";3951;1878;2073
"2020Q3";"Divorced";"Morsø";1882;908;974
"2020Q3";"Divorced";"Rebild";2385;1159;1226
"2020Q3";"Divorced";"Thisted";3758;1788;1970
"2020Q3";"Divorced";"Vesthimmerlands";3391;1584;1807
"2020Q3";"Divorced";"Aalborg";17890;7624;10266
